{
  "name": "Colony Base",
  "width": 32,
  "height": 32,
  "tileSize": 32,
  "tiles": [
    [2,2,2,2,2,2,2,2,2,2,2,2,2,2,2,2,2,2,2,2,2,2,2,2,2,2,2,2,2,2,2,2],
    [2,1,1,1,1,1,1,1,1,1,1,1,1,1,1,1,1,1,1,1,1,1,1,1,1,1,1,1,1,1,1,2],
    [2,1,0,0,0,0,0,0,0,0,0,0,0,0,0,0,0,0,0,0,0,0,0,0,0,0,0,0,0,0,1,2],
    [2,1,0,0,0,0,0,0,0,0,0,0,0,0,0,0,0,0,0,0,0,0,0,0,0,0,0,0,0,0,1,2],
    [2,1,0,0,3,3,3,3,0,0,0,0,0,0,0,0,0,0,0,0,0,0,0,0,3,3,3,3,0,0,1,2],
    [2,1,0,0,3,4,4,3,0,0,0,0,0,0,0,0,0,0,0,0,0,0,0,0,3,4,4,3,0,0,1,2],
    [2,1,0,0,3,4,4,3,0,0,0,0,0,0,0,0,0,0,0,0,0,0,0,0,3,4,4,3,0,0,1,2],
    [2,1,0,0,3,3,3,3,0,0,0,0,0,0,0,0,0,0,0,0,0,0,0,0,3,3,3,3,0,0,1,2],
    [2,1,0,0,0,0,0,0,0,0,0,0,0,0,0,0,0,0,0,0,0,0,0,0,0,0,0,0,0,0,1,2],
    [2,1,0,0,0,0,0,0,0,0,0,0,0,0,0,0,0,0,0,0,0,0,0,0,0,0,0,0,0,0,1,2],
    [2,1,0,0,0,0,0,0,0,0,0,0,0,0,0,0,0,0,0,0,0,0,0,0,0,0,0,0,0,0,1,2],
    [2,1,0,0,0,0,0,0,0,0,0,0,0,0,0,0,0,0,0,0,0,0,0,0,0,0,0,0,0,0,1,2],
    [2,1,0,0,0,0,0,0,0,0,0,0,3,3,3,3,3,3,3,3,0,0,0,0,0,0,0,0,0,0,1,2],
    [2,1,0,0,0,0,0,0,0,0,0,0,3,5,5,5,5,5,5,3,0,0,0,0,0,0,0,0,0,0,1,2],
    [2,1,0,0,0,0,0,0,0,0,0,0,3,5,5,5,5,5,5,3,0,0,0,0,0,0,0,0,0,0,1,2],
    [2,1,0,0,0,0,0,0,0,0,0,0,3,5,5,5,5,5,5,3,0,0,0,0,0,0,0,0,0,0,1,2],
    [2,1,0,0,0,0,0,0,0,0,0,0,3,5,5,5,5,5,5,3,0,0,0,0,0,0,0,0,0,0,1,2],
    [2,1,0,0,0,0,0,0,0,0,0,0,3,5,5,5,5,5,5,3,0,0,0,0,0,0,0,0,0,0,1,2],
    [2,1,0,0,0,0,0,0,0,0,0,0,3,5,5,5,5,5,5,3,0,0,0,0,0,0,0,0,0,0,1,2],
    [2,1,0,0,0,0,0,0,0,0,0,0,3,3,3,3,3,3,3,3,0,0,0,0,0,0,0,0,0,0,1,2],
    [2,1,0,0,0,0,0,0,0,0,0,0,0,0,0,0,0,0,0,0,0,0,0,0,0,0,0,0,0,0,1,2],
    [2,1,0,0,0,0,0,0,0,0,0,0,0,0,0,0,0,0,0,0,0,0,0,0,0,0,0,0,0,0,1,2],
    [2,1,0,0,0,0,0,0,0,0,0,0,0,0,0,0,0,0,0,0,0,0,0,0,0,0,0,0,0,0,1,2],
    [2,1,0,0,0,0,0,0,0,0,0,0,0,0,0,0,0,0,0,0,0,0,0,0,0,0,0,0,0,0,1,2],
    [2,1,0,0,3,3,3,3,0,0,0,0,0,0,0,0,0,0,0,0,0,0,0,0,3,3,3,3,0,0,1,2],
    [2,1,0,0,3,4,4,3,0,0,0,0,0,0,0,0,0,0,0,0,0,0,0,0,3,4,4,3,0,0,1,2],
    [2,1,0,0,3,4,4,3,0,0,0,0,0,0,0,0,0,0,0,0,0,0,0,0,3,4,4,3,0,0,1,2],
    [2,1,0,0,3,3,3,3,0,0,0,0,0,0,0,0,0,0,0,0,0,0,0,0,3,3,3,3,0,0,1,2],
    [2,1,0,0,0,0,0,0,0,0,0,0,0,0,0,0,0,0,0,0,0,0,0,0,0,0,0,0,0,0,1,2],
    [2,1,0,0,0,0,0,0,0,0,0,0,0,0,0,0,0,0,0,0,0,0,0,0,0,0,0,0,0,0,1,2],
    [2,1,1,1,1,1,1,1,1,1,1,1,1,1,1,1,1,1,1,1,1,1,1,1,1,1,1,1,1,1,1,2],
    [2,2,2,2,2,2,2,2,2,2,2,2,2,2,2,2,2,2,2,2,2,2,2,2,2,2,2,2,2,2,2,2]
  ],
  "tileTypes": {
    "0": { "name": "floor", "walkable": true },
    "1": { "name": "floor_edge", "walkable": true },
    "2": { "name": "wall", "walkable": false },
    "3": { "name": "station_border", "walkable": false },
    "4": { "name": "terminal", "walkable": true },
    "5": { "name": "hub", "walkable": true }
  }
}
